############A#######
############   #####
#############    ###
################ ###
#############    ###
######        ######
###### ######    ###
#      ########### #
### ########       #
### ######## ### ###
###          ### ###
################ ###
########         ###
######## ####### ###
####      ##########
#### ###    ###   ##
#### ###### ### ## #
#### ######        #
############### ## #
############### ## B